CAPA: hab_status_trend_chl_2021.

1. Institución recolectora original (cuál institución que hizo la recolección de los datos de su fuente).

- Sistema de Información y Monitoreo de Biodiversidad (SIMBIO) Chile.

2. Institución que provee los datos a este proyecto (si es distinta de la recolectora).

- Ministerio del Medio Ambiente.

3. Citas detalladas de la fuente, si se trata de uno o más artículos científicos.

- Ministerio del Medio Ambiente. 2016. Clasificación de ecosistemas marinos chilenos de la zona económica exclusiva. Disponible en 
  https://mma.gob.cl/wp-content/uploads/2018/03/Clasificacion-ecosistemas-marinos-de-Chile.pdf.

4. Método de captura de los datos. Si fue un estudio realizado para obtener esos datos, si se hizo utilizando algún instrumento de medición, cual método se aplicó, si se utilizó una encuesta o formulario para recogerlos, etc

- Mapas de distribución espacial en ZEE. Los tipos de hábitats se agruparon considerando solo los grupos mas diferenciados en cuánto a las características oceanográficas y morfológicas.

Hábitat MMA (2016)	                                Hábitat OHI  

Abisal  - Pacifico Austral Oceanico	                Abisal
Abisal  - Pacifico Sudeste	                        Abisal
Batibentonico  - Pacifico Austral Oceanico	        Bentonico
Batibentonico  - Pacifico Sudeste	                Bentonico
Beagle Ballenero  - Magallanes	                        Canales
Canales de la Patagonia Central - Chiloe Taitao	        Canales
Canales de la Patagonia Central - Kawesqar	        Canales
Canales de la Patagonia Central - Magallanes	        Canales
Canales de la Patagonia Norte  - Chiloe Taitao	        Canales
Canales de la Patagonia Sur  - Magallanes	        Canales
Cockburn Magdalena  - Magallanes	                Canales
Whitesidel  - Magallanes	                        Canales
Bahia Inutil  - Magallanes	                        Costa
Costa de Chiloe Continental  - Chiloe Taitao	        Costa
Costa Este de Chiloe  - Chiloe Taitao	                Costa
Nassau Hornos  - Magallanes	                        Costa
Costa expuesta de Golfo de Penas  - Chiloe Taitao	Costa expuesta
Costa Expuesta de Patagonia Central  - Kawesqar	        Costa expuesta
Costa Expuesta de Patagonia Sur  - Magallanes	        Costa expuesta
Costa expuesta Patagonia Norte  - Chiloe Taitao	        Costa expuesta
Epibentonico  - Atacama	                                Bentonico
Epibentonico Blando - Atacama	                        Bentonico
Epibentonico Blando - Centro sur	                Bentonico
Epibentonico Blando - Chile central	                Bentonico
Epibentonico Blando - Los Molles	                Bentonico
Epibentonico Blando - Norte grande	                Bentonico
Epibentonico Blando - Paposo Taltal	                Bentonico
Epibentonico Duro - Atacama	                        Bentonico
Epibentonico Duro - Centro sur	                        Bentonico
Epibentonico Duro - Chile central	                Bentonico
Epibentonico Duro - Los Molles	                        Bentonico
Epibentonico Duro - Norte grande	                Bentonico
Epibentonico Duro - Paposo Taltal	                Bentonico
Estrecho de Magallanes Central  - Magallanes	        Estrechos
Estrecho de Magallanes Este     - Magallanes	        Estrechos
Estrecho de Magallanes Oeste    - Magallanes	        Estrechos
Fiordos de Chiloe Continental   - Chiloe Taitao	        Fiordos
Fiordos de la Patagonia Central - Chiloe Taitao	        Fiordos
Fiordos de la Patagonia Central - Kawesqar	        Fiordos
Fiordos de la Patagonia Central - Magallanes	        Fiordos
Fiordos de la Patagonia Norte   - Chiloe Taitao	        Fiordos
Fiordos de la Patagonia Sur     - Magallanes	        Fiordos
Litoral        - Atacama	                        Litoral
Litoral        - Chile central	                        Litoral
Litoral        - Los Molles	                        Litoral
Litoral        - Norte grande	                        Litoral
Litoral        - Paposo Taltal	                        Litoral
Litoral Blando - Atacama	                        Litoral
Litoral Blando - Centro sur	                        Litoral
Litoral Blando - Chile central	                        Litoral
Litoral Blando - Los Molles	                        Litoral
Litoral Blando - Norte grande	                        Litoral
Litoral Blando - Paposo Taltal	                        Litoral
Litoral Duro   - Atacama	                        Litoral
Litoral Duro   - Centro sur	                        Litoral
Litoral Duro   - Chile central	                        Litoral
Litoral Duro   - Los Molles	                        Litoral
Litoral Duro   - Norte grande	                        Litoral
Litoral Duro   - Paposo Taltal	                        Litoral
Mesobentonico  - Atacama	                        Bentonico
Mesobentonico  - Centro sur	                        Bentonico
Mesobentonico  - Pacifico Austral Oceanico	        Bentonico
Mesobentonico  - Pacifico Sudeste	                Bentonico
Mesobentonico  - Paposo Taltal	                        Bentonico
Otway Jeronimo  - Magallanes	                        Senos
Senos del Golfo de Penas  - Chiloe Taitao	        Senos
Almirantazgo       - Magallanes	                        Senos
Zona de Surgencia  - Atacama	                        Zona de surgencia
Zona de Surgencia  - Chile central	                Zona de surgencia
Zona de Surgencia  - Los Molles	                        Zona de surgencia
Zona de Surgencia  - Norte grande	                Zona de surgencia


 
5. Periodo de tiempo que cubren los datos (año, mes, día desde y año, mes, día hasta).

- 2016

6. Unidad en la cual vienen los valores.

- km2.

7. Significado, explicación de cómo se deben interpretar los valores.

- En esa capa de datos corresponde a la superficie de cada habitat (km2) dentro de cada ZEE por rgn. 

8. Observación o comentario adicional sobre los datos.

- No existe tendencia de estos hábitats, por lo que se uso el mismo valor para todos los años de tendencia (2017-2020).

9. Significado y explicación de las columnas que se incluirán en el archivo, si son diferentes de las que se especifican en OHI-ecu o si la capa de datos es nueva, creada para este estudio regional. 

- En la primera columna de la capa de datos están los identificadores de cada región (rgn_id). En la segunda columna está el nombre de cada región (rgn_name). En la tercera columna está el tipo de hábitat y
  en la cuarta, quinta, sexta, séptima, octava y novena columna se muestra la superficie (km2) de cada hábitat para cada año analizado.

10. Fecha de revisión: 

- 8 de junio de 2023.